tables-claude

Tables pour le fake-sirh-2
Tables Core - Identité et Structure

companies - Données de l'entreprise (nom, secteur, taille, culture...)
employees - Profils individuels (nom, âge, ancienneté, compétences...)
departments - Services/divisions (nom, budget, objectifs...)
positions - Postes/fonctions (titre, niveau, responsabilités...)
locations - Sites géographiques (adresses, capacité, type...)

Tables Organisationnelles

org_hierarchy - Relations hiérarchiques manager/managé
teams - Équipes projets et groupes de travail
employee_positions - Historique des affectations
employee_departments - Rattachements aux services

Tables Contractuelles et Administrative

contracts - Types de contrats, durées, conditions
salaries - Historique des rémunérations
benefits - Avantages sociaux, mutuelle, tickets resto...
time_tracking - Présences, congés, RTT, absences
expenses - Notes de frais et remboursements

Tables Performance et Développement

performance_reviews - Évaluations annuelles/semestrielles
objectives - Objectifs individuels et collectifs
skills - Référentiel de compétences
employee_skills - Évaluations des compétences par employé
trainings - Catalogue de formations
training_records - Historique des formations suivies

Tables Processus RH

recruitments - Processus de recrutement en cours/passés
candidates - Profils des candidats
interviews - Entretiens menés
onboarding - Processus d'intégration
offboarding - Processus de départ

Tables Événements et Communication

events - Événements d'entreprise, team building...
announcements - Communications internes
feedback - Retours et suggestions des employés
incidents - Incidents RH (disciplinaires, etc.)


